................................
........................C.......
.........E............C.........
........####....................
...C...............###..........
########.............###........
##############################..