................................
................C...............
...........E..#####.............
........=====...................
.......=.......................
.......###########.......P......
################################





